000000000000000
111111111111111
111111111111111
111111111111111
111111111111111
111111111111111
000000000000000
011111111111111
011111111111111
011111111111111
011111111111111
011111111111111
000000000000000